10
  + + + + + + + + +
  +               +
. . . . . . .     +
. . . . . . .     +
. . . . @ . .     +
. . . . . . .     +
. . . . . . .     +
. . . . . . . + + +
W . . . . +          
. . . + + +          