10
+ + + + + + + + + +
+ @ . . + . . . . +
+ . + . + . + + . +
+ . + . . . + . . +
+ . + + + . + . + +
+ . . . + . . . + +
+ + + . + + + . . +
+ . . . . . + . + +
+ . + + + + + . . +
+ . . . . . . . S +
+ + + + + + + + + +
