12
          . . . .      
    + + + . . . .      
    +     . . . .      
    +           +      
. . @ . . . T   + + + +
. . . . . . .         +
. . . . . . .         +
. . . . . . .         +
. . . . . . .         +
. . . . . . . + + + + +
. . . . . . .          
. . . . . . . + + + + +
